XXXXXXXXXXXXXXXX
Xs aXX   X   XpX
X   XX X       X
XX     X X XXX X
X  XXX P X     X
X      X      fX
XXXXX  XX XXX XX
X      XX      X
X  XXX XX X  X X
X XX    X XXXX X
X     X X      X
XX XX zPP X   XX
X   XXXXX  X XXX
E p XpzaX X    X
X   X   P    X X
XXXXXXXXXXXXXXSX