XXXXXXXXXXXXXXXX
X      X       X
X  X   M   XX pX
X  X  XX    XXXX
XXPXaXX      XXX
E  XXX   XX    X
X  XXXX XXXX X X
X       X    XPX
XXXXX   X  XXXaX
XX    X     XXXX
XX   XXX       X
X     XXXX   X X
X   X    X XXXPX
XMX   X    XX  S
XpX  XXX  M    X
XXXXXXXXXXXXXXXX