XXXXXXEXXXXXXXXX
X  aXX   X   XpX
X   XX X       X
XX     X X XXX X
X  XXX P X     X
X      X      fX
XXXXX sXX XXX XX
X      XX      X
X TXXX XX X  X X
X XX    X XXXX X
X    zX X      X
XX?XX  PA X   XX
X   XXXXX  X XXX
X p XpzaX X    X
X   X   P    X X
XXXXXXXXXXXXXXSX