XXXXXXXXXXXXXXEX
XXX        X   X
Xaf X  X     p X
XXXXX XXX XX   X
X      z   XXXXX
X X XXXX X     X
XXX X    X XXX X
X   X XPXX     X
XzX X X XXXX X X
X     X      XzX
X p X     X  XpX
XXXXXXXX XXXXXXX
X s   X     XppX
S   X X   X X  X
X s X     X    X
XXXXXXXXXXXXXXXX