XXXXXXXXXXXXXXXX
X      X       X
X  X   z   XX pX
X  X  XX    XXXX
XXPXaXX      XXX
E  XXX   XX    X
X  XXXX XXXX X X
X       X    XPX
XXXXX   X  XXXaX
XX    X     XXXX
XX   XXX       X
X     XXXX   X X
X   X    X XXXPX
XzX   X    XX  S
XpX  XXX  f    X
XXXXXXXXXXXXXXXX