XXXXXXXXXXXXXXXX
X      X       X
X  X   z   XX pX
X  X  XX    XXXX
XXPXaXX      XXX
E ?XXX   XX    X
X  XTXX XXXX X X
X       X    XAX
XXXXX   X  XXXaX
XX    X     XXXX
XX   XXX       X
X     XXXX   X X
X   X    X XXXPX
XzX   X    XX  S
XpX  XXX  f    X
XXXXXXXXXXXXXXXX