XXXXXXXXXXXXXXEX
XXX        X   X
XaM X  X     p X
XXXXX XXX XX   X
X      M   XXXXX
X X XXXX X     X
XXX X    X XXX X
X   X XPXX     X
XMX X X XXXX X X
X     X      XMX
X p X     X  XpX
XXXXXXXX  XXXXXX
X M  XX     XppX
S         X X  X
X M  XX   X    X
XXXXXXXXXXXXXXXX