XXXXXXXXXXXX
X          X
X      M   S
X          X
X          X
E   XX   a X
X   XX     X
X          X
X          X
X   p      X
X     P    X
XXXXXXXXXXXX